1111111111
1111111101
10P0E10001
1C100001C1
1111111111
