1111111111
11111E0001
11P1C10001
1100000001
1111111111
