1111111111
11111E1001
11P0C10001
1110000001
1111111111
