11111111111
1P010000001
1000C000001
100100001E1
11111111111
