1111111111
100E000001
10P0CC0001
1000000001
1111111111
