111111111111111111
1000000000000C0001
100001000000000001
10P010000000000001
100010000001000001
100010001000001001
100010001000001001
100010C01000001001
100010000001100001
100010000000000001
100010111111010001
100C10000000010001
10001000000001E001
111111111111111111
