1111111111111111111111111111111111111111
1P00000000000000C00000000000011111110C01
1000001111111111000000000000000000000001
1000000000000000001000000000000000100001
1000C00000000000001000001111100000100001
1000001110000000001000000000000000100001
1000000C000000000010000C0000000010000001
100000000000000000100000100000001000C001
10000C111111C000001000001000000010000001
1000000000000000001000001000000010000001
1000000000000000001000000000000010000001
1000000000000000001000000000000010000001
1000CCCC000000000010000000000C0000000001
1000000001000000001000000000000000000001
1000000001000000000000000111111111000001
1000000001000000000100000000000000000001
1000000001000000000100000001110000000001
1000000001000000000100000000000000000001
1000000000000000C000000000000C0000000001
100000000000C000000000100000000000000001
10000000000000000000001000000000000000E1
1111111111111111111111111111111111111111
