11111111111111111111
1000000000000C000111
100C01C0C000C0000111
10PC10C0C000C0000111
100C10C0C001C0000111
100C10C0C000C0100111
100C10C0C000C0100111
100C10C0C000C0100111
100C10C0C001C0000111
100C10C0C000C0000111
100C10C1C111C1000111
100C10C0C000C1000111
10001000000001E00111
11111111111111111111
11111111111111111111
