1111111111111111111111111111111111111111
1000000000000C00011111111111111111111111
100C01C0C000C000011111111111111111111111
10PC10C0C000C000011111111111111111111111
100C10C0C001C000011111111111111111111111
100C10C0C000C010011111111111111111111111
100C10C0C000C010011111111111111111111111
100C10C0C000C010011111111111111111111111
100C10C0C001C000011111111111111111111111
100C10C0C000C000011111111111111111111111
100C10C1C111C100011111111111111111111111
100C10C0C000C100011111111111111111111111
10001000000001E0011111111111111111111111
1111111111111111111111111111111111111111
1111111111111111111111111111111111111111
1111111111111111111111111111111111111111
1111111111111111111111111111111111111111
1111111111111111111111111111111111111111
1111111111111111111111111111111111111111
1111111111111111111111111111111111111111
1111111111111111111111111111111111111111
1111111111111111111111111111111111111111
