111111111111111111
1P10001000100010E1
101010101010101001
101010101010101101
101010101010101C01
101010101010101101
101010101010101001
101010101010101011
101010101010101001
101010101010101101
101010101010101001
101010101010101011
100010001000100001
111111111111111111
